{
"name": "Tal der Könige",
"theme": "egypt",
"spawn": [
2,
14
],
"solid": [
"....................................................................................................................................................................................",
"....................................................................................................................................................................................",
"....................................................................................................................................................................................",
"....................................................................................................................................................................................",
"....................................................................................................................................................................................",
"....................................................................................................................................................................................",
"....................................................................................................................................................................................",
"....................................................................................................................................................................................",
"....................................................................................................................................................................................",
"..................................................................WWWWWWW.....................................................WWWWWWW...............................................",
"..................................WWWWWWW...........................................................................................................................................",
"................................................................................................WWWWWWW.............................................................................",
"....................................................................................................................................................................................",
"....................................................................................................................................................................................",
"....................................................................................................................................................................................",
"AAAAAAAAAAAAAAAAAAAAAAAA......AAAAAAAAAAAAAAAAAA.......AAAAAAAAAAAAAAAAAAAAAAA.......AAAAAAAAAAAAAAAAAAAAAAA.......AAAAAAAAAAAAAAAAAAAAAAAAA.......AAAAAAAAAAAAAAA......AAAAAAAAAAAA",
"WWWWWWWWWWWWWWWWWWWWWWWW......WWWWWWWWWWWWWWWWWW.......WWWWWWWWWWWWWWWWWWWWWWW.......WWWWWWWWWWWWWWWWWWWWWWW.......WWWWWWWWWWWWWWWWWWWWWWWWW.......WWWWWWWWWWWWWWW......WWWWWWWWWWWW"
],
"props": [
[
"pyramid",
30,
14
],
[
"pyramid",
150,
14
],
[
"sphinx",
92,
14
],
[
"palm",
12,
14
],
[
"palm",
160,
14
]
],
"entities": [
[
"mplat",
48,
12,
54,
9,
3
],
[
"mplat",
108,
11,
114,
11,
3
],
[
"box",
36,
8
],
[
"box",
37,
8
],
[
"spring",
22,
14
],
[
"spring",
76,
14
],
[
"spring",
138,
14
],
[
"coin",
25,
8
],
[
"coin",
26,
7
],
[
"coin",
27,
8
],
[
"coin",
49,
8
],
[
"coin",
50,
7
],
[
"coin",
51,
8
],
[
"coin",
79,
8
],
[
"coin",
80,
7
],
[
"coin",
81,
8
],
[
"coin",
109,
8
],
[
"coin",
110,
7
],
[
"coin",
111,
8
],
[
"coin",
142,
8
],
[
"coin",
143,
7
],
[
"coin",
144,
8
],
[
"growth",
68,
7
],
[
"fishrain",
100,
8
],
[
"cat",
16,
14
],
[
"cat",
62,
14
],
[
"cat",
120,
14
],
[
"cat",
174,
14
],
[
"shooter",
44,
14
],
[
"shooter",
90,
14
],
[
"shooter",
150,
14
],
[
"flyer",
70,
6,
6
],
[
"flyer",
130,
6,
7
],
[
"checkpoint",
86,
14
],
[
"goal",
176,
14
]
]
}