{
"name": "Pyramidengruft",
"theme": "egypt",
"spawn": [
2,
14
],
"solid": [
".........................................................................................................................................................................................",
".........................................................................................................................................................................................",
".........................................................................................................................................................................................",
".........................................................................................................................................................................................",
".........................................................................................................................................................................................",
".........................................................................................................................................................................................",
".........................................................................................................................................................................................",
".........................................................................................................................................................................................",
".........................................................................................................................................................................................",
"............................................................WWWWWWW.....................................................WWWWWWW..........................................................",
"................................WWWWWWW...............................................................................................................WWWWWWW............................",
"..........................................................................................WWWWWWW........................................................................................",
".........................................................................................................................................................................................",
".........................................................................................................................................................................................",
".........................................................................................................................................................................................",
"AAAAAAAAAAAAAAAAAAAAAA.....AAAAAAAAAAAAAAAAA.......AAAAAAAAAAAAAAAAAAA.......AAAAAAAAAAAAAAAAAAAAA.......AAAAAAAAAAAAAAAAAAAAA.......AAAAAAAAAAAAAAAAAAAAAAA.......AAAAAAAAAAAAAAAAAAAAAA",
"WWWWWWWWWWWWWWWWWWWWWW.....WWWWWWWWWWWWWWWWW.......WWWWWWWWWWWWWWWWWWW.......WWWWWWWWWWWWWWWWWWWWW.......WWWWWWWWWWWWWWWWWWWWW.......WWWWWWWWWWWWWWWWWWWWWWW.......WWWWWWWWWWWWWWWWWWWWWW"
],
"props": [
[
"pyramid",
28,
14
],
[
"sphinx",
70,
14
],
[
"pyramid",
160,
14
],
[
"cactus",
14,
14
],
[
"cactus",
142,
14
]
],
"entities": [
[
"mplat",
44,
12,
50,
9,
3
],
[
"mplat",
98,
11,
104,
11,
3
],
[
"box",
34,
7
],
[
"box",
122,
7
],
[
"spring",
20,
14
],
[
"spring",
88,
14
],
[
"spring",
148,
14
],
[
"coin",
23,
8
],
[
"coin",
24,
7
],
[
"coin",
25,
8
],
[
"coin",
45,
8
],
[
"coin",
46,
7
],
[
"coin",
47,
8
],
[
"coin",
71,
8
],
[
"coin",
72,
7
],
[
"coin",
73,
8
],
[
"coin",
99,
8
],
[
"coin",
100,
7
],
[
"coin",
101,
8
],
[
"coin",
127,
8
],
[
"coin",
128,
7
],
[
"coin",
129,
8
],
[
"coin",
157,
8
],
[
"coin",
158,
7
],
[
"coin",
159,
8
],
[
"growth",
62,
7
],
[
"fish",
34,
12
],
[
"cat",
16,
14
],
[
"cat",
56,
14
],
[
"cat",
108,
14
],
[
"cat",
168,
14
],
[
"spiky",
36,
14
],
[
"spiky",
80,
14
],
[
"spiky",
138,
14
],
[
"shooter",
66,
14
],
[
"shooter",
116,
14
],
[
"flyer",
52,
6,
6
],
[
"flyer",
112,
6,
7
],
[
"checkpoint",
78,
14
],
[
"checkpoint",
134,
14
],
[
"goal",
181,
14
]
]
}