{
"name": "Sonnige Hänge",
"theme": "sunset",
"spawn": [
2,
14
],
"solid": [
"................................................................................................................................................................",
"................................................................................................................................................................",
"................................................................................................................................................................",
"................................................................................................................................................................",
"................................................................................................................................................................",
"................................................................................................................................................................",
"................................................................................................................................................................",
"................................................................................................................................................................",
"................................................................................................................................................................",
"............................................................BBBBB.....................................................BBBBB.....................................",
"......................................................................................BBBBB.....................................................................",
"................................................................................................................................................................",
"................................................................................................................................................................",
"................................................................................................................................................................",
"................................................................................................................................................................",
"GGGGGGGGGGGGGGGGGGGGGGGG.....GGGGGGGGGGGGGGGGG.......GGGGGGGGGGGGGGGGGGGGG......GGGGGGGGGGGGGGGGGGGGGGGG.......GGGGGGGGGGGGGGGGGGGGG......GGGGGGGGGGGGGGGGGGGGGG",
"DDDDDDDDDDDDDDDDDDDDDDDD.....DDDDDDDDDDDDDDDDD.......DDDDDDDDDDDDDDDDDDDDD......DDDDDDDDDDDDDDDDDDDDDDDD.......DDDDDDDDDDDDDDDDDDDDD......DDDDDDDDDDDDDDDDDDDDDD"
],
"props": [
[
"bush",
8,
14
],
[
"bush",
35,
14
],
[
"bush",
92,
14
],
[
"bush",
145,
14
],
[
"tree",
18,
14
],
[
"tree",
100,
14
]
],
"entities": [
[
"mplat",
46,
11,
52,
11,
3
],
[
"mplat",
104,
12,
110,
8,
3
],
[
"spring",
22,
14
],
[
"spring",
72,
14
],
[
"spring",
130,
14
],
[
"coin",
25,
8
],
[
"coin",
26,
7
],
[
"coin",
27,
8
],
[
"coin",
48,
9
],
[
"coin",
49,
8
],
[
"coin",
50,
9
],
[
"coin",
75,
8
],
[
"coin",
76,
7
],
[
"coin",
77,
8
],
[
"coin",
106,
10
],
[
"coin",
107,
9
],
[
"coin",
108,
10
],
[
"coin",
133,
8
],
[
"coin",
134,
7
],
[
"coin",
135,
8
],
[
"coin",
60,
8
],
[
"coin",
61,
8
],
[
"coin",
62,
8
],
[
"coin",
63,
8
],
[
"coin",
64,
8
],
[
"coin",
86,
9
],
[
"coin",
87,
9
],
[
"coin",
88,
9
],
[
"coin",
89,
9
],
[
"coin",
90,
9
],
[
"coin",
118,
8
],
[
"coin",
119,
8
],
[
"coin",
120,
8
],
[
"coin",
121,
8
],
[
"coin",
122,
8
],
[
"growth",
62,
8
],
[
"snowball",
16,
14
],
[
"snowball",
40,
14
],
[
"snowball",
66,
14
],
[
"snowball",
96,
14
],
[
"snowball",
124,
14
],
[
"snowball",
150,
14
],
[
"flyer",
55,
8,
5
],
[
"flyer",
115,
7,
5
],
[
"checkpoint",
80,
14
],
[
"goal",
156,
14
]
]
}