{
"name": "Frostkönigs Festung",
"theme": "cave",
"spawn": [
2,
14
],
"solid": [
"..............................................",
"..............................................",
"..............................................",
".SS........................................SS.",
".SS........................................SS.",
".SS........................................SS.",
".SS........................................SS.",
".SS........................................SS.",
".SS........................................SS.",
".SS........................................SS.",
".SS........................................SS.",
".SS......SSSSS...................SSSSS.....SS.",
".SS........................................SS.",
".SS........................................SS.",
".SS........................................SS.",
"SSSSSSSSSSSSSSSSSSSSSSSSSSSSSSSSSSSSSSSSSSSSSS",
"SSSSSSSSSSSSSSSSSSSSSSSSSSSSSSSSSSSSSSSSSSSSSS"
],
"props": [],
"entities": [
[
"coin",
14,
9
],
[
"coin",
15,
8
],
[
"coin",
16,
9
],
[
"coin",
30,
9
],
[
"coin",
31,
8
],
[
"coin",
32,
9
],
[
"coin",
21,
8
],
[
"coin",
22,
8
],
[
"coin",
23,
8
],
[
"coin",
24,
8
],
[
"coin",
25,
8
],
[
"growth",
6,
14
],
[
"boss",
23,
14
]
],
"music": "boss.ogg"
}