{
"name": "Frostwind-Grat",
"theme": "ice",
"spawn": [
2,
14
],
"solid": [
"..........................................................................................................................................................................",
"..........................................................................................................................................................................",
"..........................................................................................................................................................................",
"..........................................................................................................................................................................",
"..........................................................................................................................................................................",
"..........................................................................................................................................................................",
"..........................................................................................................................................................................",
"..........................................................................................................................................................................",
"..........................................................................................................................................................................",
"..................................................................IIIIIII...........................................................IIIIIII...............................",
"....................IIIIIII.........................................................................IIIIIII...............................................................",
"..........................................................................................................................................................................",
"..........................................................................................................................................................................",
"..........................................................................................................................................................................",
"..........................................................................................................................................................................",
"IIIIIIIIIIIIIIIIIIIIIIIIIIII.....IIIIIIIIIIIIIIIIIIIII.......IIIIIIIIIIIIIIIIIIIIIIIII......IIIIIIIIIIIIIIIIIIIIIIIIII.......IIIIIIIIIIIIIIIIIIIII......IIIIIIIIIIIIIIIIII",
"IIIIIIIIIIIIIIIIIIIIIIIIIIII.....IIIIIIIIIIIIIIIIIIIII.......IIIIIIIIIIIIIIIIIIIIIIIII......IIIIIIIIIIIIIIIIIIIIIIIIII.......IIIIIIIIIIIIIIIIIIIII......IIIIIIIIIIIIIIIIII"
],
"props": [],
"entities": [
[
"mplat",
54,
11,
60,
8,
3
],
[
"mplat",
118,
12,
124,
12,
3
],
[
"spring",
26,
14
],
[
"spring",
84,
14
],
[
"spring",
144,
14
],
[
"coin",
29,
8
],
[
"coin",
30,
7
],
[
"coin",
31,
8
],
[
"coin",
56,
9
],
[
"coin",
57,
8
],
[
"coin",
58,
9
],
[
"coin",
87,
8
],
[
"coin",
88,
7
],
[
"coin",
89,
8
],
[
"coin",
120,
9
],
[
"coin",
121,
8
],
[
"coin",
122,
9
],
[
"coin",
147,
8
],
[
"coin",
148,
7
],
[
"coin",
149,
8
],
[
"coin",
66,
8
],
[
"coin",
67,
8
],
[
"coin",
68,
8
],
[
"coin",
69,
8
],
[
"coin",
70,
8
],
[
"coin",
71,
8
],
[
"coin",
72,
8
],
[
"coin",
100,
9
],
[
"coin",
101,
9
],
[
"coin",
102,
9
],
[
"coin",
103,
9
],
[
"coin",
104,
9
],
[
"coin",
105,
9
],
[
"coin",
106,
9
],
[
"coin",
132,
8
],
[
"coin",
133,
8
],
[
"coin",
134,
8
],
[
"coin",
135,
8
],
[
"coin",
136,
8
],
[
"coin",
137,
8
],
[
"coin",
138,
8
],
[
"growth",
68,
7
],
[
"spiky",
18,
14
],
[
"spiky",
46,
14
],
[
"spiky",
78,
14
],
[
"spiky",
110,
14
],
[
"spiky",
158,
14
],
[
"snowball",
40,
14
],
[
"snowball",
96,
14
],
[
"flyer",
62,
7,
6
],
[
"flyer",
128,
6,
7
],
[
"checkpoint",
92,
14
],
[
"goal",
166,
14
],
[
"star",
42,
12
],
[
"star",
85,
12
],
[
"star",
127,
12
]
],
"weather": "snow",
"wind": -220
}