{
"name": "Tiefe Stollen",
"theme": "cave",
"spawn": [
2,
14
],
"solid": [
"...............................................................................................................................................................................",
"...............................................................................................................................................................................",
"...............................................................................................................................................................................",
"...............................................................................................................................................................................",
"...............................................................................................................................................................................",
"...............................................................................................................................................................................",
"...............................................................................................................................................................................",
"...............................................................................................................................................................................",
"...............................................................................................................................................................................",
"..................................................................SSSSSSS.....................................................SSSSSSS..........................................",
"..................................SSSSSSS......................................................................................................................................",
"................................................................................................SSSSSSS........................................................................",
"...............................................................................................................................................................................",
"...............................................................................................................................................................................",
"...............................................................................................................................................................................",
"SSSSSSSSSSSSSSSSSSSSSSSS......SSSSSSSSSSSSSSSSSS.......SSSSSSSSSSSSSSSSSSSSSSS.......SSSSSSSSSSSSSSSSSSSSSSS.......SSSSSSSSSSSSSSSSSSSSSSS......SSSSSSSSSSSSSS......SSSSSSSSSSS",
"SSSSSSSSSSSSSSSSSSSSSSSS......SSSSSSSSSSSSSSSSSS.......SSSSSSSSSSSSSSSSSSSSSSS.......SSSSSSSSSSSSSSSSSSSSSSS.......SSSSSSSSSSSSSSSSSSSSSSS......SSSSSSSSSSSSSS......SSSSSSSSSSS"
],
"props": [],
"entities": [
[
"mplat",
48,
12,
54,
9,
3
],
[
"mplat",
108,
11,
114,
11,
3
],
[
"spring",
22,
14
],
[
"spring",
76,
14
],
[
"spring",
136,
14
],
[
"coin",
25,
9
],
[
"coin",
26,
8
],
[
"coin",
27,
9
],
[
"coin",
49,
9
],
[
"coin",
50,
8
],
[
"coin",
51,
9
],
[
"coin",
79,
9
],
[
"coin",
80,
8
],
[
"coin",
81,
9
],
[
"coin",
109,
9
],
[
"coin",
110,
8
],
[
"coin",
111,
9
],
[
"coin",
139,
9
],
[
"coin",
140,
8
],
[
"coin",
141,
9
],
[
"coin",
66,
8
],
[
"coin",
67,
8
],
[
"coin",
68,
8
],
[
"coin",
69,
8
],
[
"coin",
70,
8
],
[
"coin",
71,
8
],
[
"coin",
72,
8
],
[
"coin",
96,
10
],
[
"coin",
97,
10
],
[
"coin",
98,
10
],
[
"coin",
99,
10
],
[
"coin",
100,
10
],
[
"coin",
101,
10
],
[
"coin",
102,
10
],
[
"coin",
126,
8
],
[
"coin",
127,
8
],
[
"coin",
128,
8
],
[
"coin",
129,
8
],
[
"coin",
130,
8
],
[
"coin",
131,
8
],
[
"coin",
132,
8
],
[
"growth",
36,
8
],
[
"spiky",
16,
14
],
[
"spiky",
44,
14
],
[
"spiky",
90,
14
],
[
"spiky",
150,
14
],
[
"spiky",
170,
14
],
[
"snowball",
60,
14
],
[
"snowball",
120,
14
],
[
"flyer",
70,
7,
6
],
[
"flyer",
130,
6,
7
],
[
"checkpoint",
86,
14
],
[
"goal",
171,
14
]
]
}