{
"name": "Abgrundtiefe",
"theme": "cave",
"spawn": [
2,
14
],
"solid": [
"...................................................................................................................................................................................................",
"...................................................................................................................................................................................................",
"...................................................................................................................................................................................................",
"...................................................................................................................................................................................................",
"...................................................................................................................................................................................................",
"...................................................................................................................................................................................................",
"...................................................................................................................................................................................................",
"...................................................................................................................................................................................................",
"...................................................................................................................................................................................................",
"..............................................................................SSSSSSS.................................................SSSSSSS......................................................",
"................................SSSSSSS............................................................................................................................................................",
"........................................................................................................SSSSSSS....................................................................................",
"...................................................................................................................................................................................................",
"...................................................................................................................................................................................................",
"...................................................................................................................................................................................................",
"SSSSSSSSSSSSSSSSSSSSSS......SSSSSSSSSSSSSS.......SSSSSSSSSSSSSSSSS.......SSSSSSSSSSSSSSSSSSS.......SSSSSSSSSSSSSSSSSSSSS.......SSSSSSSSSSSSSSSSSSSSSSS.......SSSSSSSSSSSSSSSSSSS......SSSSSSSSSSSSS",
"SSSSSSSSSSSSSSSSSSSSSS......SSSSSSSSSSSSSS.......SSSSSSSSSSSSSSSSS.......SSSSSSSSSSSSSSSSSSS.......SSSSSSSSSSSSSSSSSSSSS.......SSSSSSSSSSSSSSSSSSSSSSS.......SSSSSSSSSSSSSSSSSSS......SSSSSSSSSSSSS"
],
"props": [],
"entities": [
[
"mplat",
42,
12,
48,
9,
3
],
[
"mplat",
92,
11,
98,
11,
3
],
[
"mplat",
150,
10,
156,
13,
3
],
[
"spring",
20,
14
],
[
"spring",
90,
14
],
[
"spring",
148,
14
],
[
"coin",
23,
8
],
[
"coin",
24,
7
],
[
"coin",
25,
8
],
[
"coin",
43,
8
],
[
"coin",
44,
7
],
[
"coin",
45,
8
],
[
"coin",
67,
8
],
[
"coin",
68,
7
],
[
"coin",
69,
8
],
[
"coin",
93,
8
],
[
"coin",
94,
7
],
[
"coin",
95,
8
],
[
"coin",
121,
8
],
[
"coin",
122,
7
],
[
"coin",
123,
8
],
[
"coin",
151,
8
],
[
"coin",
152,
7
],
[
"coin",
153,
8
],
[
"growth",
34,
8
],
[
"growth",
136,
7
],
[
"snowball",
16,
14
],
[
"snowball",
56,
14
],
[
"snowball",
100,
14
],
[
"snowball",
160,
14
],
[
"snowball",
188,
14
],
[
"spiky",
36,
14
],
[
"spiky",
80,
14
],
[
"spiky",
108,
14
],
[
"spiky",
138,
14
],
[
"spiky",
178,
14
],
[
"flyer",
50,
6,
6
],
[
"flyer",
110,
5,
7
],
[
"flyer",
164,
6,
6
],
[
"checkpoint",
74,
14
],
[
"checkpoint",
132,
14
],
[
"goal",
191,
14
],
[
"star",
49,
12
],
[
"star",
99,
12
],
[
"star",
146,
12
]
]
}