{
"name": "Innenstadt bei Nacht",
"theme": "city",
"spawn": [
2,
14
],
"solid": [
"............................................................................................................................................................................",
"............................................................................................................................................................................",
"............................................................................................................................................................................",
"............................................................................................................................................................................",
"............................................................................................................................................................................",
"............................................................................................................................................................................",
"............................................................................................................................................................................",
"............................................................................................................................................................................",
"............................................................................................................................................................................",
"............................................................................................................................................................................",
"..................................................................KKKKKKK...........................................................KKKKKKK.................................",
"....................KKKKKKK.........................................................................KKKKKKK.................................................................",
"............................................................................................................................................................................",
"............................................................................................................................................................................",
"............................................................................................................................................................................",
"CCCCCCCCCCCCCCCCCCCCCCCCCCCCCC.....CCCCCCCCCCCCCCCCCCCCC.......CCCCCCCCCCCCCCCCCCCCCCCCC......CCCCCCCCCCCCCCCCCCCCCCCCCC.......CCCCCCCCCCCCCCCCCCCCC......CCCCCCCCCCCCCCCCCC",
"KKKKKKKKKKKKKKKKKKKKKKKKKKKKKK.....KKKKKKKKKKKKKKKKKKKKK.......KKKKKKKKKKKKKKKKKKKKKKKKK......KKKKKKKKKKKKKKKKKKKKKKKKKK.......KKKKKKKKKKKKKKKKKKKKK......KKKKKKKKKKKKKKKKKK"
],
"props": [
[
"streetlamp",
10,
14
],
[
"streetlamp",
50,
14
],
[
"streetlamp",
108,
14
],
[
"streetlamp",
140,
14
],
[
"barrier",
34,
14
],
[
"barrier",
90,
14
],
[
"barrier",
126,
14
],
[
"skyscraper",
74,
14
],
[
"skyscraper",
155,
14
]
],
"entities": [
[
"mplat",
56,
12,
62,
9,
3
],
[
"mplat",
120,
11,
126,
11,
3
],
[
"spring",
28,
14
],
[
"spring",
86,
14
],
[
"spring",
146,
14
],
[
"coin",
31,
8
],
[
"coin",
32,
7
],
[
"coin",
33,
8
],
[
"coin",
58,
9
],
[
"coin",
59,
8
],
[
"coin",
60,
9
],
[
"coin",
89,
8
],
[
"coin",
90,
7
],
[
"coin",
91,
8
],
[
"coin",
122,
9
],
[
"coin",
123,
8
],
[
"coin",
124,
9
],
[
"coin",
149,
8
],
[
"coin",
150,
7
],
[
"coin",
151,
8
],
[
"coin",
66,
8
],
[
"coin",
67,
8
],
[
"coin",
68,
8
],
[
"coin",
69,
8
],
[
"coin",
70,
8
],
[
"coin",
71,
8
],
[
"coin",
72,
8
],
[
"coin",
100,
9
],
[
"coin",
101,
9
],
[
"coin",
102,
9
],
[
"coin",
103,
9
],
[
"coin",
104,
9
],
[
"coin",
105,
9
],
[
"coin",
106,
9
],
[
"coin",
132,
8
],
[
"coin",
133,
8
],
[
"coin",
134,
8
],
[
"coin",
135,
8
],
[
"coin",
136,
8
],
[
"coin",
137,
8
],
[
"coin",
138,
8
],
[
"growth",
68,
8
],
[
"fish",
22,
12
],
[
"robot",
16,
14
],
[
"robot",
44,
14
],
[
"robot",
78,
14
],
[
"robot",
110,
14
],
[
"robot",
158,
14
],
[
"snowball",
40,
14
],
[
"snowball",
96,
14
],
[
"checkpoint",
92,
14
],
[
"goal",
168,
14
]
],
"weather": "rain"
}