{
"name": "Kraterfelder",
"theme": "sunset",
"spawn": [
2,
14
],
"solid": [
"....................................................................................................................................................................................",
"....................................................................................................................................................................................",
"....................................................................................................................................................................................",
"....................................................................................................................................................................................",
"....................................................................................................................................................................................",
"....................................................................................................................................................................................",
"....................................................................................................................................................................................",
"....................................................................................................................................................................................",
"..................................................................BBBBBBB...................................................................BBBBBBB.................................",
"....................................................................................................................................................................................",
"....................BBBBBBB.........................................................................BBBBBBB.........................................................................",
"....................................................................................................................................................................................",
"....................................................................................................................................................................................",
"....................................................................................................................................................................................",
"....................................................................................................................................................................................",
"GGGGGGGGGGGGGGGGGGGGGGGGGG......GGGGGGGGGGGGGGGGGGGG.......GGGGGGGGGGGGGGGGGGGGGGGGG.......GGGGGGGGGGGGGGGGGGGGGGGGG.......GGGGGGGGGGGGGGGGGGGGGGGGG.......GGGGGGGGGGGGGGGGGGGGGGGGG",
"DDDDDDDDDDDDDDDDDDDDDDDDDD......DDDDDDDDDDDDDDDDDDDD.......DDDDDDDDDDDDDDDDDDDDDDDDD.......DDDDDDDDDDDDDDDDDDDDDDDDD.......DDDDDDDDDDDDDDDDDDDDDDDDD.......DDDDDDDDDDDDDDDDDDDDDDDDD"
],
"props": [],
"entities": [
[
"mplat",
52,
11,
58,
8,
3
],
[
"mplat",
116,
12,
122,
12,
3
],
[
"spring",
24,
14
],
[
"spring",
82,
14
],
[
"spring",
146,
14
],
[
"coin",
27,
8
],
[
"coin",
28,
7
],
[
"coin",
29,
8
],
[
"coin",
54,
8
],
[
"coin",
55,
7
],
[
"coin",
56,
8
],
[
"coin",
86,
8
],
[
"coin",
87,
7
],
[
"coin",
88,
8
],
[
"coin",
118,
8
],
[
"coin",
119,
7
],
[
"coin",
120,
8
],
[
"coin",
150,
8
],
[
"coin",
151,
7
],
[
"coin",
152,
8
],
[
"coin",
66,
7
],
[
"coin",
67,
7
],
[
"coin",
68,
7
],
[
"coin",
69,
7
],
[
"coin",
70,
7
],
[
"coin",
71,
7
],
[
"coin",
72,
7
],
[
"coin",
100,
9
],
[
"coin",
101,
9
],
[
"coin",
102,
9
],
[
"coin",
103,
9
],
[
"coin",
104,
9
],
[
"coin",
105,
9
],
[
"coin",
106,
9
],
[
"coin",
140,
7
],
[
"coin",
141,
7
],
[
"coin",
142,
7
],
[
"coin",
143,
7
],
[
"coin",
144,
7
],
[
"coin",
145,
7
],
[
"coin",
146,
7
],
[
"growth",
68,
6
],
[
"snowball",
16,
14
],
[
"snowball",
44,
14
],
[
"snowball",
78,
14
],
[
"snowball",
110,
14
],
[
"snowball",
164,
14
],
[
"spiky",
38,
14
],
[
"spiky",
96,
14
],
[
"spiky",
130,
14
],
[
"flyer",
60,
6,
6
],
[
"flyer",
128,
5,
7
],
[
"checkpoint",
92,
14
],
[
"goal",
176,
14
],
[
"star",
45,
12
],
[
"star",
91,
12
],
[
"star",
135,
12
]
]
}