{
"name": "Wüstensand",
"theme": "egypt",
"spawn": [
2,
14
],
"solid": [
"..........................................................................................................................................................................",
"..........................................................................................................................................................................",
"..........................................................................................................................................................................",
"..........................................................................................................................................................................",
"..........................................................................................................................................................................",
"..........................................................................................................................................................................",
"..........................................................................................................................................................................",
"..........................................................................................................................................................................",
"..........................................................................................................................................................................",
"..........................................................................................................................................................................",
"..................................................................WWWWWWW...........................................................WWWWWWW...............................",
"....................WWWWWWW.........................................................................WWWWWWW...............................................................",
"..........................................................................................................................................................................",
"..........................................................................................................................................................................",
"..........................................................................................................................................................................",
"AAAAAAAAAAAAAAAAAAAAAAAAAAAA.....AAAAAAAAAAAAAAAAAAAAA.......AAAAAAAAAAAAAAAAAAAAAAAAA......AAAAAAAAAAAAAAAAAAAAAAAAAA.......AAAAAAAAAAAAAAAAAAAAA......AAAAAAAAAAAAAAAAAA",
"WWWWWWWWWWWWWWWWWWWWWWWWWWWW.....WWWWWWWWWWWWWWWWWWWWW.......WWWWWWWWWWWWWWWWWWWWWWWWW......WWWWWWWWWWWWWWWWWWWWWWWWWW.......WWWWWWWWWWWWWWWWWWWWW......WWWWWWWWWWWWWWWWWW"
],
"props": [
[
"palm",
10,
14
],
[
"palm",
50,
14
],
[
"palm",
108,
14
],
[
"palm",
140,
14
],
[
"cactus",
34,
14
],
[
"cactus",
90,
14
],
[
"pyramid",
74,
14
],
[
"sphinx",
126,
14
]
],
"entities": [
[
"spring",
26,
14
],
[
"spring",
84,
14
],
[
"spring",
144,
14
],
[
"coin",
29,
8
],
[
"coin",
30,
7
],
[
"coin",
31,
8
],
[
"coin",
56,
9
],
[
"coin",
57,
8
],
[
"coin",
58,
9
],
[
"coin",
87,
8
],
[
"coin",
88,
7
],
[
"coin",
89,
8
],
[
"coin",
120,
9
],
[
"coin",
121,
8
],
[
"coin",
122,
9
],
[
"coin",
147,
8
],
[
"coin",
148,
7
],
[
"coin",
149,
8
],
[
"coin",
66,
8
],
[
"coin",
67,
8
],
[
"coin",
68,
8
],
[
"coin",
69,
8
],
[
"coin",
70,
8
],
[
"coin",
71,
8
],
[
"coin",
72,
8
],
[
"coin",
100,
9
],
[
"coin",
101,
9
],
[
"coin",
102,
9
],
[
"coin",
103,
9
],
[
"coin",
104,
9
],
[
"coin",
105,
9
],
[
"coin",
106,
9
],
[
"coin",
132,
8
],
[
"coin",
133,
8
],
[
"coin",
134,
8
],
[
"coin",
135,
8
],
[
"coin",
136,
8
],
[
"coin",
137,
8
],
[
"coin",
138,
8
],
[
"growth",
68,
8
],
[
"fish",
22,
12
],
[
"cat",
16,
14
],
[
"cat",
44,
14
],
[
"cat",
78,
14
],
[
"cat",
110,
14
],
[
"cat",
158,
14
],
[
"snowball",
40,
14
],
[
"snowball",
96,
14
],
[
"checkpoint",
92,
14
],
[
"goal",
166,
14
]
]
}