{
"name": "Eishöhle",
"theme": "ice",
"spawn": [
2,
14
],
"solid": [
"................................................................................................................................................................",
"................................................................................................................................................................",
"................................................................................................................................................................",
"................................................................................................................................................................",
"................................................................................................................................................................",
"................................................................................................................................................................",
"................................................................................................................................................................",
"................................................................................................................................................................",
"................................................................................................................................................................",
"................................................................................................................................................................",
"............................................IIIIIII.........................................................IIIIIII.............................................",
"..................IIIIIII.................................................IIIIIII...............................................................................",
"................................................................................................................................................................",
"................................................................................................................................................................",
"................................................................................................................................................................",
"IIIIIIIIIIIIIIIIIIIIIIIIIIIIII.....IIIIIIIIIIIIIIIIIIIIIII.....IIIIIIIIIIIIIIIIIIIIIIIIIIIII......IIIIIIIIIIIIIIIIIIIIIIIIII......IIIIIIIIIIIIIIIIIIIIIIIIIIIIII",
"IIIIIIIIIIIIIIIIIIIIIIIIIIIIII.....IIIIIIIIIIIIIIIIIIIIIII.....IIIIIIIIIIIIIIIIIIIIIIIIIIIII......IIIIIIIIIIIIIIIIIIIIIIIIII......IIIIIIIIIIIIIIIIIIIIIIIIIIIIII"
],
"props": [],
"entities": [
[
"mplat",
58,
12,
62,
12,
3
],
[
"mplat",
124,
11,
129,
11,
3
],
[
"coin",
31,
12
],
[
"coin",
32,
11
],
[
"coin",
33,
12
],
[
"coin",
59,
12
],
[
"coin",
60,
11
],
[
"coin",
61,
12
],
[
"coin",
93,
12
],
[
"coin",
94,
11
],
[
"coin",
95,
12
],
[
"coin",
125,
12
],
[
"coin",
126,
11
],
[
"coin",
127,
12
],
[
"coin",
18,
9
],
[
"coin",
19,
9
],
[
"coin",
20,
9
],
[
"coin",
21,
9
],
[
"coin",
22,
9
],
[
"coin",
23,
9
],
[
"coin",
24,
9
],
[
"coin",
74,
9
],
[
"coin",
75,
9
],
[
"coin",
76,
9
],
[
"coin",
77,
9
],
[
"coin",
78,
9
],
[
"coin",
79,
9
],
[
"coin",
80,
9
],
[
"coin",
108,
8
],
[
"coin",
109,
8
],
[
"coin",
110,
8
],
[
"coin",
111,
8
],
[
"coin",
112,
8
],
[
"coin",
113,
8
],
[
"coin",
114,
8
],
[
"growth",
46,
8
],
[
"spiky",
16,
14
],
[
"spiky",
46,
14
],
[
"spiky",
78,
14
],
[
"spiky",
112,
14
],
[
"spiky",
148,
14
],
[
"snowball",
40,
14
],
[
"snowball",
100,
14
],
[
"spring",
88,
14
],
[
"checkpoint",
70,
14
],
[
"goal",
156,
14
],
[
"star",
40,
12
],
[
"star",
80,
8
],
[
"star",
120,
12
]
]
}