{
"name": "Grüne Hügel 1",
"theme": "grass",
"spawn": [
2,
14
],
"solid": [
"......................................................................................................................................................",
"......................................................................................................................................................",
"......................................................................................................................................................",
"......................................................................................................................................................",
"......................................................................................................................................................",
"......................................................................................................................................................",
"......................................................................................................................................................",
"......................................................................................................................................................",
"......................................................................................................................................................",
"..........................BBB.........................................................................................................................",
"............................................BBBBBB............................................................BBBBB...................................",
"..................BBBBB.................................................BBBBBB......................................................BBBBBBBBBBBBBBBBBB",
"...................................................................................................................................G..................",
"..................................................................................................................................GD..................",
".................................................................................................................................GDD..................",
"GGGGGGGGGGGGGGGGGGGGGGGGGGGGGGG....GGGGGGGGGGGGGGGGGGGGGGGGGGGG....GGGGGGGGGGGGGGGGGGGGGGGGGGGGGGG....GGGGGGGGGGGGGGGGGGGGGGGGGGGDDDGGGGGGGGGGGGGGGGGG",
"DDDDDDDDDDDDDDDDDDDDDDDDDDDDDDD....DDDDDDDDDDDDDDDDDDDDDDDDDDDD....DDDDDDDDDDDDDDDDDDDDDDDDDDDDDDD....DDDDDDDDDDDDDDDDDDDDDDDDDDDDDDDDDDDDDDDDDDDDDDDD"
],
"props": [
[
"bush",
5,
14
],
[
"bush",
24,
14
],
[
"bush",
52,
14
],
[
"bush",
90,
14
],
[
"bush",
125,
14
],
[
"tree",
10,
14
],
[
"tree",
48,
14
],
[
"tree",
108,
14
],
[
"cloud",
12,
2
],
[
"cloud",
30,
1
],
[
"cloud",
75,
2
],
[
"cloud",
120,
2
]
],
"entities": [
[
"coin",
6,
12
],
[
"coin",
7,
12
],
[
"coin",
8,
12
],
[
"coin",
9,
12
],
[
"coin",
31,
12
],
[
"coin",
32,
11
],
[
"coin",
33,
12
],
[
"coin",
19,
9
],
[
"coin",
20,
9
],
[
"coin",
21,
9
],
[
"coin",
63,
12
],
[
"coin",
64,
11
],
[
"coin",
65,
12
],
[
"coin",
45,
8
],
[
"coin",
46,
8
],
[
"coin",
47,
8
],
[
"coin",
48,
8
],
[
"coin",
98,
12
],
[
"coin",
99,
11
],
[
"coin",
100,
12
],
[
"coin",
72,
9
],
[
"coin",
73,
9
],
[
"coin",
74,
9
],
[
"coin",
75,
9
],
[
"coin",
76,
9
],
[
"coin",
133,
10
],
[
"coin",
134,
10
],
[
"coin",
135,
10
],
[
"coin",
136,
10
],
[
"coin",
137,
10
],
[
"coin",
138,
10
],
[
"growth",
27,
8
],
[
"spring",
88,
14
],
[
"snowball",
14,
14
],
[
"snowball",
40,
14
],
[
"snowball",
58,
14
],
[
"snowball",
82,
14
],
[
"snowball",
106,
14
],
[
"snowball",
138,
14
],
[
"checkpoint",
70,
14
],
[
"goal",
146,
11
]
]
}