{
"name": "Schattenkönigs Thron",
"theme": "cave",
"spawn": [
2,
14
],
"solid": [
"................................................",
"................................................",
"................................................",
".SS..........................................SS.",
".SS..........................................SS.",
".SS..........................................SS.",
".SS..........................................SS.",
".SS..........................................SS.",
".SS..........................................SS.",
".SS..........................................SS.",
".SS..........................................SS.",
".SS......SSSSS.....................SSSSS.....SS.",
".SS..........................................SS.",
".SS..........................................SS.",
".SS..........................................SS.",
"SSSSSSSSSSSSSSSSSSSSSSSSSSSSSSSSSSSSSSSSSSSSSSSS",
"SSSSSSSSSSSSSSSSSSSSSSSSSSSSSSSSSSSSSSSSSSSSSSSS"
],
"props": [],
"entities": [
[
"coin",
15,
9
],
[
"coin",
16,
8
],
[
"coin",
17,
9
],
[
"coin",
31,
9
],
[
"coin",
32,
8
],
[
"coin",
33,
9
],
[
"coin",
22,
8
],
[
"coin",
23,
8
],
[
"coin",
24,
8
],
[
"coin",
25,
8
],
[
"coin",
26,
8
],
[
"growth",
6,
14
],
[
"boss",
24,
14,
"shadow"
]
],
"music": "boss.ogg"
}