{
"name": "Mondbasis",
"theme": "space",
"spawn": [
2,
14
],
"solid": [
"....................................................................................................................................................................................",
"....................................................................................................................................................................................",
"....................................................................................................................................................................................",
"....................................................................................................................................................................................",
"....................................................................................................................................................................................",
"....................................................................................................................................................................................",
"....................................................................................................................................................................................",
"....................................................................................................................................................................................",
"....................................................................................................................................................................................",
"..................................................................PPPPPPP.....................................................PPPPPPP...............................................",
"..................................PPPPPPP...........................................................................................................................................",
"................................................................................................PPPPPPP.............................................................................",
"....................................................................................................................................................................................",
"....................................................................................................................................................................................",
"....................................................................................................................................................................................",
"MMMMMMMMMMMMMMMMMMMMMMMM.......MMMMMMMMMMMMMMMMMMM........MMMMMMMMMMMMMMMMMMMMMM........MMMMMMMMMMMMMMMMMMMMMM........MMMMMMMMMMMMMMMMMMMMMMMM........MMMMMMMMMMMMMM.......MMMMMMMMM",
"MMMMMMMMMMMMMMMMMMMMMMMM.......MMMMMMMMMMMMMMMMMMM........MMMMMMMMMMMMMMMMMMMMMM........MMMMMMMMMMMMMMMMMMMMMM........MMMMMMMMMMMMMMMMMMMMMMMM........MMMMMMMMMMMMMM.......MMMMMMMMM"
],
"props": [
[
"rocket",
12,
14
],
[
"planet",
60,
1
],
[
"meteor",
156,
14
]
],
"entities": [
[
"mplat",
50,
12,
57,
9,
3
],
[
"mplat",
110,
11,
117,
11,
3
],
[
"box",
36,
8
],
[
"box",
37,
8
],
[
"spring",
22,
14
],
[
"spring",
78,
14
],
[
"spring",
140,
14
],
[
"coin",
25,
8
],
[
"coin",
26,
7
],
[
"coin",
27,
8
],
[
"coin",
52,
8
],
[
"coin",
53,
7
],
[
"coin",
54,
8
],
[
"coin",
82,
8
],
[
"coin",
83,
7
],
[
"coin",
84,
8
],
[
"coin",
112,
8
],
[
"coin",
113,
7
],
[
"coin",
114,
8
],
[
"coin",
144,
8
],
[
"coin",
145,
7
],
[
"coin",
146,
8
],
[
"growth",
68,
7
],
[
"fishrain",
100,
8
],
[
"alien",
16,
14
],
[
"alien",
62,
14
],
[
"alien",
120,
14
],
[
"alien",
174,
14
],
[
"shooter",
44,
14
],
[
"shooter",
90,
14
],
[
"shooter",
150,
14
],
[
"flyer",
70,
6,
6
],
[
"flyer",
130,
6,
7
],
[
"checkpoint",
86,
14
],
[
"goal",
176,
14
]
]
}