{
"name": "Nacht am Hügel",
"theme": "night",
"spawn": [
2,
14
],
"solid": [
".....................................................................................................................................................................",
".....................................................................................................................................................................",
".....................................................................................................................................................................",
".....................................................................................................................................................................",
".....................................................................................................................................................................",
".....................................................................................................................................................................",
".....................................................................................................................................................................",
".....................................................................................................................................................................",
".....................................................................................................................................................................",
"................................................................BBBBBBB.........................................................BBBBBBB..............................",
"....................BBBBB.........................................................................BBBBBBB............................................................",
".....................................................................................................................................................................",
".....................................................................................................................................................................",
".....................................................................................................................................................................",
".....................................................................................................................................................................",
"GGGGGGGGGGGGGGGGGGGGGGGGGG.....GGGGGGGGGGGGGGGGGGGGG......GGGGGGGGGGGGGGGGGGGGGGGGGG......GGGGGGGGGGGGGGGGGGGGGGGGGG......GGGGGGGGGGGGGGGGGG......GGGGGGGGGGGGGGGGGGG",
"DDDDDDDDDDDDDDDDDDDDDDDDDD.....DDDDDDDDDDDDDDDDDDDDD......DDDDDDDDDDDDDDDDDDDDDDDDDD......DDDDDDDDDDDDDDDDDDDDDDDDDD......DDDDDDDDDDDDDDDDDD......DDDDDDDDDDDDDDDDDDD"
],
"props": [
[
"tree",
12,
14
],
[
"tree",
100,
14
],
[
"cloud",
20,
2
],
[
"cloud",
70,
1
],
[
"cloud",
130,
2
]
],
"entities": [
[
"mplat",
52,
11,
57,
8,
3
],
[
"mplat",
116,
12,
121,
12,
3
],
[
"spring",
24,
14
],
[
"spring",
82,
14
],
[
"spring",
138,
14
],
[
"coin",
27,
8
],
[
"coin",
28,
7
],
[
"coin",
29,
8
],
[
"coin",
53,
9
],
[
"coin",
54,
8
],
[
"coin",
55,
9
],
[
"coin",
85,
8
],
[
"coin",
86,
7
],
[
"coin",
87,
8
],
[
"coin",
117,
9
],
[
"coin",
118,
8
],
[
"coin",
119,
9
],
[
"coin",
141,
8
],
[
"coin",
142,
7
],
[
"coin",
143,
8
],
[
"coin",
64,
8
],
[
"coin",
65,
8
],
[
"coin",
66,
8
],
[
"coin",
67,
8
],
[
"coin",
68,
8
],
[
"coin",
69,
8
],
[
"coin",
70,
8
],
[
"coin",
98,
9
],
[
"coin",
99,
9
],
[
"coin",
100,
9
],
[
"coin",
101,
9
],
[
"coin",
102,
9
],
[
"coin",
103,
9
],
[
"coin",
104,
9
],
[
"coin",
128,
8
],
[
"coin",
129,
8
],
[
"coin",
130,
8
],
[
"coin",
131,
8
],
[
"coin",
132,
8
],
[
"coin",
133,
8
],
[
"coin",
134,
8
],
[
"growth",
66,
7
],
[
"snowball",
16,
14
],
[
"snowball",
44,
14
],
[
"snowball",
74,
14
],
[
"snowball",
108,
14
],
[
"snowball",
150,
14
],
[
"spiky",
38,
14
],
[
"spiky",
96,
14
],
[
"spiky",
132,
14
],
[
"flyer",
60,
7,
6
],
[
"flyer",
124,
6,
7
],
[
"checkpoint",
90,
14
],
[
"goal",
161,
14
],
[
"star",
41,
12
],
[
"star",
82,
12
],
[
"star",
123,
12
]
],
"weather": "fog"
}