{
"name": "Startrampe",
"theme": "space",
"spawn": [
2,
14
],
"solid": [
"..........................................................................................................................................................................",
"..........................................................................................................................................................................",
"..........................................................................................................................................................................",
"..........................................................................................................................................................................",
"..........................................................................................................................................................................",
"..........................................................................................................................................................................",
"..........................................................................................................................................................................",
"..........................................................................................................................................................................",
"..........................................................................................................................................................................",
"..........................................................................................................................................................................",
"....................................................................PPPPPP............................................................PPPPPP..............................",
"......................PPPPPP........................................................................PPPPPPP...............................................................",
"..........................................................................................................................................................................",
"..........................................................................................................................................................................",
"..........................................................................................................................................................................",
"MMMMMMMMMMMMMMMMMMMMMMMMMMMMMM......MMMMMMMMMMMMMMMMMMMMMM.......MMMMMMMMMMMMMMMMMMMMMMMMM.......MMMMMMMMMMMMMMMMMMMMMMMMM.......MMMMMMMMMMMMMMMMMMMMM.......MMMMMMMMMMMMM",
"MMMMMMMMMMMMMMMMMMMMMMMMMMMMMM......MMMMMMMMMMMMMMMMMMMMMM.......MMMMMMMMMMMMMMMMMMMMMMMMM.......MMMMMMMMMMMMMMMMMMMMMMMMM.......MMMMMMMMMMMMMMMMMMMMM.......MMMMMMMMMMMMM"
],
"props": [
[
"rocket",
8,
14
],
[
"meteor",
52,
14
],
[
"meteor",
108,
14
],
[
"planet",
20,
2
],
[
"planet",
80,
1
],
[
"planet",
140,
2
]
],
"entities": [
[
"mplat",
58,
12,
64,
9,
3
],
[
"mplat",
122,
11,
128,
11,
3
],
[
"spring",
28,
14
],
[
"spring",
86,
14
],
[
"spring",
146,
14
],
[
"coin",
31,
8
],
[
"coin",
32,
7
],
[
"coin",
33,
8
],
[
"coin",
60,
8
],
[
"coin",
61,
7
],
[
"coin",
62,
8
],
[
"coin",
92,
8
],
[
"coin",
93,
7
],
[
"coin",
94,
8
],
[
"coin",
124,
8
],
[
"coin",
125,
7
],
[
"coin",
126,
8
],
[
"coin",
152,
8
],
[
"coin",
153,
7
],
[
"coin",
154,
8
],
[
"coin",
68,
8
],
[
"coin",
69,
8
],
[
"coin",
70,
8
],
[
"coin",
71,
8
],
[
"coin",
72,
8
],
[
"coin",
73,
8
],
[
"coin",
100,
9
],
[
"coin",
101,
9
],
[
"coin",
102,
9
],
[
"coin",
103,
9
],
[
"coin",
104,
9
],
[
"coin",
105,
9
],
[
"coin",
106,
9
],
[
"growth",
70,
8
],
[
"fish",
24,
12
],
[
"alien",
16,
14
],
[
"alien",
46,
14
],
[
"alien",
80,
14
],
[
"alien",
112,
14
],
[
"alien",
158,
14
],
[
"checkpoint",
94,
14
],
[
"goal",
166,
14
]
]
}