{
"name": "Frostpalast",
"theme": "ice",
"spawn": [
2,
14
],
"solid": [
".........................................................................................................................................................................................",
".........................................................................................................................................................................................",
".........................................................................................................................................................................................",
".........................................................................................................................................................................................",
".........................................................................................................................................................................................",
".........................................................................................................................................................................................",
".........................................................................................................................................................................................",
".........................................................................................................................................................................................",
".........................................................................................................................................................................................",
"..............................................................IIIIIII.............................................................IIIIIII................................................",
"..................IIIIIII................................................................................................................................................................",
"................................................................................................IIIIIII..................................................................................",
".........................................................................................................................................................................................",
".........................................................................................................................................................................................",
".........................................................................................................................................................................................",
"IIIIIIIIIIIIIIIIIIIIIIII......IIIIIIIIIIIIIIIIIIII.......IIIIIIIIIIIIIIIIIIIIIII.......IIIIIIIIIIIIIIIIIIIIIIIII.......IIIIIIIIIIIIIIIIIIIIIIIII.......IIIIIIIIIIIIIII......IIIIIIIIIIIII",
"IIIIIIIIIIIIIIIIIIIIIIII......IIIIIIIIIIIIIIIIIIII.......IIIIIIIIIIIIIIIIIIIIIII.......IIIIIIIIIIIIIIIIIIIIIIIII.......IIIIIIIIIIIIIIIIIIIIIIIII.......IIIIIIIIIIIIIII......IIIIIIIIIIIII"
],
"props": [],
"entities": [
[
"mplat",
50,
12,
56,
8,
3
],
[
"mplat",
112,
11,
118,
11,
3
],
[
"spring",
22,
14
],
[
"spring",
78,
14
],
[
"spring",
142,
14
],
[
"coin",
25,
8
],
[
"coin",
26,
7
],
[
"coin",
27,
8
],
[
"coin",
52,
8
],
[
"coin",
53,
7
],
[
"coin",
54,
8
],
[
"coin",
82,
8
],
[
"coin",
83,
7
],
[
"coin",
84,
8
],
[
"coin",
114,
8
],
[
"coin",
115,
7
],
[
"coin",
116,
8
],
[
"coin",
146,
8
],
[
"coin",
147,
7
],
[
"coin",
148,
8
],
[
"growth",
64,
7
],
[
"spiky",
16,
14
],
[
"spiky",
44,
14
],
[
"spiky",
90,
14
],
[
"spiky",
150,
14
],
[
"spiky",
180,
14
],
[
"snowball",
60,
14
],
[
"snowball",
120,
14
],
[
"flyer",
70,
6,
6
],
[
"flyer",
134,
5,
7
],
[
"checkpoint",
88,
14
],
[
"goal",
181,
14
],
[
"star",
46,
12
],
[
"star",
92,
12
],
[
"star",
138,
12
]
],
"weather": "snow",
"wind": 200
}