{
"name": "Kristallhöhle",
"theme": "cave",
"spawn": [
2,
14
],
"solid": [
".........................................................................................................................................................................................",
".........................................................................................................................................................................................",
".........................................................................................................................................................................................",
".........................................................................................................................................................................................",
".........................................................................................................................................................................................",
".........................................................................................................................................................................................",
".........................................................................................................................................................................................",
".........................................................................................................................................................................................",
".........................................................................................................................................................................................",
"..........................................................................SSSSSSS...............................................SSSSSSS..................................................",
"................................SSSSS....................................................................................................................................................",
"....................................................................................................SSSSSSS..............................................................................",
".........................................................................................................................................................................................",
".........................................................................................................................................................................................",
".........................................................................................................................................................................................",
"SSSSSSSSSSSSSSSSSSSSSS.....SSSSSSSSSSSSS......SSSSSSSSSSSSSSSS.......SSSSSSSSSSSSSSSSSSS.......SSSSSSSSSSSSSSSSS.......SSSSSSSSSSSSSSSSSSSSS.......SSSSSSSSSSSSS......SSSSSSSSSSSSSSSSSSS",
"SSSSSSSSSSSSSSSSSSSSSS.....SSSSSSSSSSSSS......SSSSSSSSSSSSSSSS.......SSSSSSSSSSSSSSSSSSS.......SSSSSSSSSSSSSSSSS.......SSSSSSSSSSSSSSSSSSSSS.......SSSSSSSSSSSSS......SSSSSSSSSSSSSSSSSSS"
],
"props": [],
"entities": [
[
"mplat",
40,
12,
45,
9,
3
],
[
"mplat",
62,
11,
68,
11,
3
],
[
"mplat",
112,
10,
118,
13,
3
],
[
"mplat",
160,
12,
165,
12,
4
],
[
"spring",
20,
14
],
[
"spring",
86,
14
],
[
"spring",
138,
14
],
[
"coin",
23,
9
],
[
"coin",
24,
8
],
[
"coin",
25,
9
],
[
"coin",
41,
9
],
[
"coin",
42,
8
],
[
"coin",
43,
9
],
[
"coin",
63,
9
],
[
"coin",
64,
8
],
[
"coin",
65,
9
],
[
"coin",
89,
9
],
[
"coin",
90,
8
],
[
"coin",
91,
9
],
[
"coin",
113,
9
],
[
"coin",
114,
8
],
[
"coin",
115,
9
],
[
"coin",
141,
9
],
[
"coin",
142,
8
],
[
"coin",
143,
9
],
[
"coin",
161,
9
],
[
"coin",
162,
8
],
[
"coin",
163,
9
],
[
"coin",
74,
8
],
[
"coin",
75,
8
],
[
"coin",
76,
8
],
[
"coin",
77,
8
],
[
"coin",
78,
8
],
[
"coin",
79,
8
],
[
"coin",
80,
8
],
[
"coin",
100,
10
],
[
"coin",
101,
10
],
[
"coin",
102,
10
],
[
"coin",
103,
10
],
[
"coin",
104,
10
],
[
"coin",
105,
10
],
[
"coin",
106,
10
],
[
"coin",
128,
8
],
[
"coin",
129,
8
],
[
"coin",
130,
8
],
[
"coin",
131,
8
],
[
"coin",
132,
8
],
[
"coin",
133,
8
],
[
"coin",
134,
8
],
[
"growth",
34,
8
],
[
"growth",
130,
7
],
[
"snowball",
16,
14
],
[
"snowball",
52,
14
],
[
"snowball",
96,
14
],
[
"snowball",
150,
14
],
[
"snowball",
178,
14
],
[
"spiky",
34,
14
],
[
"spiky",
78,
14
],
[
"spiky",
104,
14
],
[
"spiky",
132,
14
],
[
"spiky",
172,
14
],
[
"flyer",
48,
7,
6
],
[
"flyer",
108,
6,
7
],
[
"flyer",
156,
7,
6
],
[
"checkpoint",
70,
14
],
[
"checkpoint",
130,
14
],
[
"goal",
181,
14
]
]
}